000001000000000000000000000000000000000000000000
000000000000000000000000000000000000000000000000
000000000000100000000000000000000000000000000000
000000000000000000000000000000000000000000000000
000000000000000000000000000000000000000000000000
000000000000000000000000000000000000000000000000
000000000000000000000000000000000000000000000000
000000000000000000000000000000000000000000000000
000100000000000000000000000000000000000000000000
000000000000000000000000000000000000000000000000
000000000000000000000000010000000000000000000000
000000010000000000100000000000000000000000000000
000000000000000000000000000000000000000000000000
000000000000000000000000000000000000000000000000
101111111111111111111111111111111111111111111111
000111111111111111111111111111111111110000000000
000000000000000000000000000000000000000000000000
000000000000010111111101100000000000000000000000