
111111111111111111111111111111000000000000000000000000000000000000000000000000111111111111111111111111111111
111111111111111111111111111111000000000000000000000000000000000000000000000000111111111111111111111111111111
111111111111111111111111111111000000000000000000000000000000000000000000000000111111111111111111111111111111
111111111111111111111111111111000000000000000000000000000000000000000000000000111111111111111111111111111111
111111111111111111111111111111000000000000000000000000000000000000000000000000111111111111111111111111111111
111111111111111111111111111111000000000000000000000000000000000000000000000000111111111111111111111111111111
111111111111111111111111111111000000000000000000000000000000000000000000000000111111111111111111111111111111
111111111111111111111111111111000000000000000000000000000000000000000000000000111111111111111111111111111111
111111111111111111111111111111000000000000000000000000000000000000000000000000111111111111111111111111111111
111111111111111111111111111111000000000000000000000000000000000000000000000000111111111111111111111111111111
111111111111111111111111111111000000000000000000000000000000000000000000000000111111111111111111111111111111
111111111111111111111111111111000000000000000000000000000000000000000000000000111111111111111111111111111111
111111111111111111111111111111000000000000000000000000000000000000000000000000111111111111111111111111111111
111111111111111111111111111111000001000000000000000000000000000000000000000000111111111111111111111111111111
111111111111111111111111111111000000000000000000000000000000000000000000000000111111111111111111111111111111
111111111111111111111111111111000000000000100000000000000000000000000000000000111111111111111111111111111111
111111111111111111111111111111000000000000000000000000000000000000000000000000111111111111111111111111111111
111111111111111111111111111111000000000000000000000000000000000000000000000000111111111111111111111111111111
111111111111111111111111111111000000000000000000000000000000000000000000000000111111111111111111111111111111
111111111111111111111111111111000000000000000000000000000000000000000000000000111111111111111111111111111111
111111111111111111111111111111000000000000000000000000000000000000000000000000111111111111111111111111111111
111111111111111111111111111111000100000000000000000000000000000000000000000000111111111111111111111111111111
111111111111111111111111111111000000000000000000000000000000000000000000000000111111111111111111111111111111
111111111111111111111111111111000000000000000000000000010000000000000000000000111111111111111111111111111111
111111111111111111111111111111000000010000000000100000000000000000000000000000111111111111111111111111111111
111111111111111111111111111111000000000000000000000000000000000000000000000000111111111111111111111111111111
111111111111111111111111111111000000110000000000000000000000000000000000000000111111111111111111111111111111
111111111111111111111111111111101111111111111111111111111111111211111111000001111111111111111111111111111111
111111111111111111111111111111000111111111111111111111111111111111110000000000111111111111111111111111111111
111111111111111111111111111111000000000111111111111111111111110000000000001000111111111111111111111111111111
111111111111111111111111111111000000000000010111111101100000000000000000011000111111111111111111111111111111
111111111111111111111111111111000000000000000000000000000000000000000000011000111111111111111111111111111111
111111111111111111111111111111000000000000000000000000000000000000000001111000111111111111111111111111111111
111111111111111111111111111111000000000000000000000000000000000000000111111000111111111111111111111111111111
111111111111111111111111111111000000000000000000000000000000000000001111111000111111111111111111111111111111
111111111111111111111111111111000000000000000000000000000000000000011111111000111111111111111111111111111111
111111111111111111111111111111000000000000000000000000000000000000000000000000111111111111111111111111111111
111111111111111111111111111111000000000000000000000000000000000000000000000000111111111111111111111111111111
111111111111111111111111111111111111111111111111111111111111111111111111111111111111111111111111111111111111
111111111111111111111111111111111111111111111111111111111111111111111111111111111111111111111111111111111111
111111111111111111111111111111111111111111111111111111111111111111111111111111111111111111111111111111111111
111111111111111111111111111111111111111111111111111111111111111111111111111111111111111111111111111111111111
111111111111111111111111111111111111111111111111111111111111111111111111111111111111111111111111111111111111
111111111111111111111111111111111111111111111111111111111111111111111111111111111111111111111111111111111111
111111111111111111111111111111111111111111111111111111111111111111111111111111111111111111111111111111111111
111111111111111111111111111111111111111111111111111111111111111111111111111111111111111111111111111111111111
111111111111111111111111111111111111111111111111111111111111111111111111111111111111111111111111111111111111
111111111111111111111111111111111111111111111111111111111111111111111111111111111111111111111111111111111111
111111111111111111111111111111111111111111111111111111111111111111111111111111111111111111111111111111111111
111111111111111111111111111111111111111111111111111111111111111111111111111111111111111111111111111111111111
111111111111111111111111111111111111111111111111111111111111111111111111111111111111111111111111111111111111
111111111111111111111111111111111111111111111111111111111111111111111111111111111111111111111111111111111111
111111111111111111111111111111111111111111111111111111111111111111111111111111111111111111111111111111111111
111111111111111111111111111111111111111111111111111111111111111111111111111111111111111111111111111111111111
111111111111111111111111111111111111111111111111111111111111111111111111111111111111111111111111111111111111
111111111111111111111111111111111111111111111111111111111111111111111111111111111111111111111111111111111111
111111111111111111111111111111111111111111111111111111111111111111111111111111111111111111111111111111111111
111111111111111111111111111111111111111111111111111111111111111111111111111111111111111111111111111111111111
111111111111111111111111111111111111111111111111111111111111111111111111111111111111111111111111111111111111
111111111111111111111111111111111111111111111111111111111111111111111111111111111111111111111111111111111111
111111111111111111111111111111111111111111111111111111111111111111111111111111111111111111111111111111111111
111111111111111111111111111111111111111111111111111111111111111111111111111111111111111111111111111111111111
111111111111111111111111111111111111111111111111111111111111111111111111111111111111111111111111111111111111
111111111111111111111111111111111111111111111111111111111111111111111111111111111111111111111111111111111111
111111111111111111111111111111111111111111111111111111111111111111111111111111111111111111111111111111111111
111111111111111111111111111111111111111111111111111111111111111111111111111111111111111111111111111111111111
111111111111111111111111111111111111111111111111111111111111111111111111111111111111111111111111111111111111
111111111111111111111111111111111111111111111111111111111111111111111111111111111111111111111111111111111111
111111111111111111111111111111111111111111111111111111111111111111111111111111111111111111111111111111111111
111111111111111111111111111111111111111111111111111111111111111111111111111111111111111111111111111111111111
111111111111111111111111111111111111111111111111111111111111111111111111111111111111111111111111111111111111
111111111111111111111111111111111111111111111111111111111111111111111111111111111111111111111111111111111111
111111111111111111111111111111111111111111111111111111111111111111111111111111111111111111111111111111111111
111111111111111111111111111111111111111111111111111111111111111111111111111111111111111111111111111111111111
111111111111111111111111111111111111111111111111111111111111111111111111111111111111111111111111111111111111
111111111111111111111111111111111111111111111111111111111111111111111111111111111111111111111111111111111111
111111111111111111111111111111111111111111111111111111111111111111111111111111111111111111111111111111111111
111111111111111111111111111111111111111111111111111111111111111111111111111111111111111111111111111111111111
111111111111111111111111111111111111111111111111111111111111111111111111111111111111111111111111111111111111
111111111111111111111111111111111111111111111111111111111111111111111111111111111111111111111111111111111111
111111111111111111111111111111111111111111111111111111111111111111111111111111111111111111111111111111111111
111111111111111111111111111111111111111111111111111111111111111111111111111111111111111111111111111111111111
111111111111111111111111111111111111111111111111111111111111111111111111111111111111111111111111111111111111
111111111111111111111111111111111111111111111111111111111111111111111111111111111111111111111111111111111111
111111111111111111111111111111111111111111111111111111111111111111111111111111111111111111111111111111111111
111111111111111111111111111111111111111111111111111111111111111111111111111111111111111111111111111111111111
111111111111111111111111111111111111111111111111111111111111111111111111111111111111111111111111111111111111


